14
ATCGCGTGTTCCCGTCGTTACC
41
Lulita=TCAAGGCCATAACCGGTGCTAT
Janella=CCACTGACTGGTAGGTATCACT
Jackquelin=ACTCGATTAGTCCTACGAACAC
Sarette=AGATGGATAGGGGTTCCACTGG
Selene=CACTAAACCTTCCTCGGCCGGA
Minne=GATTTTACGTGTAGTTGACACC
Ynes=GGGTACAAACCCGGTGGACTAA
Sherline=TTGCCAATGTGCCACCTGCCTA
Glory=TAGCACGATTGTCGGTTCACAT
Stephana=CGTCACCAAGCACGCTCTGTAG
Atlante=TACCGCGTATGGAGAAAGATAA
Karee=CTAGAAACGGAAATAAATGACG
Perry=GCTTTAAAGTTTGTTCCTACAT
Faun=CACATTGTCCCCCACCTCGTAG
Lindi=AATTGCAAACTGAGTCGCGAGG
Maisie=GAAACTGAAGCCCCTACAGGTG
Edy=AAGAACCCTAGAAATAGATGTG
Cecelia=TTATTGTGGAAACAGCCTAGTA
Robinia=GTGCTCAACACGCAGCCAAATT
Orsola=GAGTCGTATACCAGAGTAGTAG
Brett=GTCTGGTCAAACATACAGCGCT
Kaile=ACGTGGGGTTACATTTAGGGCT
Evvie=TTCCAACTTGCAGTCACGGGTA
Janessa=AGTAGATGTGGGGTACTTTTCT
Sybyl=TATTCGTAGAGGCCTGCAAACT
Roxi=GCGATATCGCCGGCCTAACGCA
Ardith=TCCATAGGGCATCAGTAAATTG
Rene=GCTCGAAGCGCATTATGCGAAG
Caprice=GGTCGCGCAGCGGGCTATTGAG
Ranee=ATGAGAAATGTGGTGCGCGTAA
Matty=GCCTCTAAAAGGAACAGGGCGG
Kiley=TCTAGATTGCGGGACATGGCCA
Jordana=GCCGAGGATCTTCGTCAGGTTA
Ansley=TGGGTGGTTAAAATATGGCCAA
Gwendolen=GAGTGTTGGCGCGTCCACATTG
Shandie=CGACGATTGAGTTGGTCCCTAA
Coralyn=CTGGCTTCTGTCACGTGCTCCT
Linn=ACAGTGTGTCGGAGGGTACGAA
Fiorenze=CAAAGCCTAAGGCCGTCCCGAC
Agretha=GCCGAATGGAACCATTGTGAAG
Genna=GTAACTATCTATGTTGGTCTTC
TAGGATTTCTAG
57
Jaquelin=CCTGTGACAAAA
Molly=AAATGCCTCTCG
Anna-Diana=CATATACAGTAG
Lorenza=TCGACCCTCCCG
Lorita=AGAGGTTAATCT
Meggie=TTTAATTAATAG
Chelsae=GGCTACGACAAG
Neile=TGCAGTATGACT
Stephanie=ATTTTTCTTGCC
Bria=TGTCCTGGAATT
Rivkah=GACTAGCGAGCA
Karyn=TAGATCCTTGAG
Devinne=CTTCATTATGGG
Gussi=CTGTCATAGCTC
Rosmunda=AATGAACCAAGG
Hortense=TGCCTCCACGTC
Myrna=AATCCACTTTGT
Cathrine=CACAAACTAACG
Deva=TCGTGTCATTTC
Lilian=ATTCTAGCCAAA
Rebekkah=GGTTATTAGGTA
Elizabeth=GTGCATGCCAAC
Madalena=ACCCGACGCAGA
Pansie=AGAATTGCTAGT
Rozina=TCGAGGAGAAAG
Farrah=CTAAACGGGATG
Bethany=TGCAACAATCTG
Adrienne=TGCCTCCCACTA
Essie=TTCAGGTACTGT
Camel=GCTCATGACTAC
Agata=GAACGCCGTTCA
Michele=GGGCCGGAGTTC
Corrianne=ACGGTCATAGTA
Maurizia=GATAGTTGGATG
Amelia=CGGTGCGATAGC
Starla=AGGGATTCATTA
Jonis=CTGACACCAGTC
Marney=TATATCGTCTTT
Rosene=AAAAGGACGGAT
Christabella=CACATCTGATGA
Manda=GTCGATATAACC
Bernie=TGTGTGTCCTTA
Aleen=ACTCATATAGGA
Jaine=AATCAGCCAAAT
Daniele=AAACCAAGCTCA
Erina=GCGGTATCGCTG
Johnath=CCTGAAACGGGT
Aurie=AAGAATAAATGG
Tedi=GCAGGCTGAAAT
Agathe=CTGATTCGCGCG
Guendolen=TCTGTTTGCCTT
Christian=AGTCGCTGCCTC
Joelie=GGGTTTATGTGT
Cindelyn=CCAAGTTCGAGT
Phelia=CCTATCTATCCT
Sibyl=GAGAAATGCTGG
Aprilette=GGTCGTTACAGC
AATA
2
Retha=TGTG
Marena=CTGC
ATAGAAAGCGGGGG
88
Sari=GTCAAGGGCCCAGT
Isidora=GGAGCAAGCACGTA
Carita=CAATGCTACACCAT
Clotilda=CAGAGACATACTAT
Ursola=AGTAGTGTCATTAG
Starr=GTACGGGAGGGATC
Sheree=TTTTCCCGCAGCGG
Caril=AGTGCCAGCCAAAG
Alecia=AGTAAGATACCGTC
Laraine=GTGGGATGGGGAGA
Haleigh=TATCGTGGATTCAA
Shelba=ATACATCCATACGC
Marlene=TAACATCCACCCCG
Shaylynn=AAGTAGACAGTGAT
Deeyn=ACTCATAAGATCGC
Suzi=GCCGGCAGTCAACT
Thea=TAGAACCTCTAATC
Malorie=TAGGTTCCAGCGAT
Nanete=TTGTAGTAGCAATC
Barbara-Anne=AAAACGCTTCGTGT
Tiffi=AACGGCCCTCCCGA
Arluene=GTCAAATCGTTGGC
Vanda=TCGGGCTGCATATC
Marie=TTGAGGTTGTTTGA
Nadia=GCGAGAATCCAACA
Nydia=AAGGTCGTTCCTCG
Anthiathia=CGCTTACCGTACTA
Kiele=CCGCGACTGATACT
Brana=TAAGGCTTCTCTAA
Sibeal=GGGACGCCTCGGCC
Floria=TAATCTTTAAAGAA
Quintina=ACTCAACCACTATA
Jodee=GTGTTGCTTGTCTT
Koressa=GGTTGGCACTAGAC
Leslie=GAAGTTACAAAGTA
Eveleen=ATGACGTCCGTTGA
Rosella=CATTGTTATCTCGT
Adrienne=AGGAATGGAGCTAC
Zaria=GTGTAAAACAGTCT
Carmel=GCCGGGTTCATTGG
Krystal=GAACCTTTGATTAG
Susie=GGGATGCTTATCGA
Britney=ATTTCTTTTTACTG
Roshelle=CGTTAGTTCATGAG
Kimmy=AAGCACAACCGAGA
Malina=GTGGGGGGGTTGCG
Jobi=GGCCTCGCACAGTT
Sindee=GAGGTACTGAATAT
Simone=CCTGTGGAAAGGGA
Katharina=TACCCAAGATATTA
Ardis=AACTTCTTTCTCGA
Christye=CAGGCAGAGAACCA
Farah=GACTAGCGGGTTTG
Frannie=GGGTAACTATCCTG
Maura=GCATCGGTGGATAT
Iona=GCACTCGGGGCCTG
Fleurette=GGTTCTGCAATGAT
Constanta=TCTTTCGCGATATA
Dierdre=GGTTCGGTCAACGT
Margery=CACGATCCTACTAC
Francisca=GCAAGACTGCAGTC
Korry=GAGATCTAGTCCAG
Vickie=GGAACCTACGTAAC
Wynne=AACCGGAATTTGCA
Nanon=TGAAGGTGGAACTG
Carlina=AAGCTCATAACCTA
Ursulina=TGCAGGAGTGCGAT
Audrye=AGACTTGGTACCTT
Corette=GTGCACAGTGCGGT
Maude=CTCACTCTTACCTC
Dorey=TCTGTCCCGTACGG
Ardra=GGTTTTCACTAGAT
Kristine=GCTCACCTTATCGT
Daniele=GCACGCAGCTAAAT
Antonina=TTGTTCGTCCTTGT
Ninon=CAGGTCCTCGCCGC
Bridie=TACGGCAGAACATT
Rori=AACCAATTACATGA
Marga=CGTTGAAGGTGGAA
Cassey=ACTTGCTCATCTCC
Coral=GGTTTTCCATGTAC
Madelene=GAAATTAACACGAC
Appolonia=TTTTAGACCCTCGA
Fern=TTGATAAGCAATCT
Coraline=AGCTTCTGAGTCTG
Jacquetta=ATGGAATGCGTTCA
Glynnis=CATTAAGCCCGAAC
Verina=TTACAGTCACCTGC
AAGGT
13
Alejandrina=AACCG
Sasha=TGCTC
Timmi=TATCA
Dolley=TGTGG
Eloisa=GATTT
Sada=CTTCA
Averyl=CAAGT
Lin=AATGG
Perry=ACTTG
Milly=CTTTC
Coral=ATGTA
Sarina=CTGTG
Carlita=CGTAC
ATG
78
Maribel=CGG
Jenine=TTA
Sidoney=CAT
Katherine=CGA
Ronica=CGA
Josie=ACC
Bobinette=TCC
Sherrie=CGC
Emmye=TAG
Alicea=CTG
Danny=GGA
Helene=TGC
Christa=GTG
Lotty=GCG
Devina=CGA
Elnore=CCG
Susanne=GGT
Ophelie=CTT
Dollie=CCT
Enrica=CCG
Alleen=GGT
Yoshi=CCA
Lenette=GAG
Leanora=CTC
Ermina=GTT
Mariann=GAG
Lisabeth=AGA
Tina=CAC
Freddie=TAG
Donetta=TAG
Toni=TCT
Mil=AGC
Aurelea=TCC
Hynda=ATT
Betteanne=GTA
Marigold=CTC
Merline=CAG
Jobie=CGA
Tomasine=ACC
Kat=CGC
Germain=CTC
Wenda=TTT
Cybil=AGT
Kati=CCA
Kelci=AAC
Evy=CAC
Felicdad=GGG
Electra=TCG
Cristina=CGC
Lyndy=GCC
Elana=CGA
Tasia=CGA
Riki=TAA
Crissy=AAT
Shantee=TAA
Sapphire=TTT
Livvie=TGG
Antonella=GAC
Wendeline=GTT
Revkah=CGA
Corinna=ATG
Kandace=CGG
Billy=CGA
Becka=TAG
Sapphira=AAT
Suzanna=TGG
Kacey=TGA
Tedi=CTA
Devonna=CAA
Peg=GCA
Anthia=CCC
Darelle=AGC
Leann=TTC
Shel=GTA
Verina=AGT
Ki=GAC
Aprilette=GAT
Susi=AAC
CCATCGGGTAGCTGGAGGAATACA
42
Rafaela=GTGATGACATAGACAACAATCGGC
Esma=GAGTGGCGTAAGCCTCAGAGATGG
Lindie=GAAATACGACCTGGCCTATCTTAA
Amaleta=TCATAAATGTCCCTAATACGATAT
Cordelia=GCGCTTACCGAGCACGTAACCCTT
Shela=CGAGAGATTGGTTGGGGATGTGCG
Sheree=TGCTTTGTCCGTGAACGGGCCATA
Dorolisa=CCTCTTTTTTTTTCGCCGCCACGC
Malina=TGATAAGTTTGGGTTGCCAATACC
Robbie=GCGGGTTGGTCCGTCCAACAGAGA
Adaline=ATTCAGGATTCACAGTTACACTGT
Aubrey=ATCTTTAGAATACTGCGGAAAAAG
Lyssa=GATTGTGACAACCCCGTGAATGGT
Andie=CCAAACTTGTAATGTACAGGCTGC
Shauna=GACTTTTACCCATGCCTCTTGGTG
Sapphire=TGATCCATGCCATTCCCTCACGAA
Jacqui=CGATACGTCTACCGAACAGTTAAC
Delly=TCACTATCAATGCTTACGCCCACC
Morgen=CTGGGCACTGGAGGCTATTGTACT
Marji=TAAGGCTACGAATGCAAAGTCTCT
Melli=TCGATCTCGTCCTCGAATCACCAC
Aundrea=CGTGTCCCTCTACGTGATACGTAG
Deloris=TATTCAAATGCTCGATAATCGGTA
Rowena=CGATCTGACGAACCCTCCAAGCTC
Stacey=ATTAACTCTATGTTGACCATCCAT
Tamarah=TAATTCTTTTGCCGGGCCCCTGGA
Muire=TGCAGTGTTTCTGAGACCGTACTG
Tera=TGTTAATAACAGGATTTATCGGCA
Billye=GGCACAAACTGGTGGTTATTAGGT
Kamilah=TTCCGTATCCCACATACGTCTGTC
Myrna=GACCACTTTAGTTTCTTGGAATCC
Winonah=CACTTGTAACACTTCTAATGATTT
Monica=CACAACGTTCCCGTACAGTATGGT
Romy=CCCCAGGGCCACACATGCCGGCAG
Matty=ATGCACATTGTACCAATCGGTCAT
Maryjane=TGCAGCCCTCCATATTTTAGCTGT
Elfrieda=GTTGGGAACGCATAGCTGCCACAT
Eddy=GTTAGTGATTGCGAATGCCCTTTT
Aggi=ACCGTTCCTTCCGCGTGGTTTGGT
Jade=CACTTCAACCGTTAGTCGACACGT
Laryssa=CAGAGGTAGTGAAGAGAAGCCGGT
Charmine=GGGACACAGGCGAGATACCGATAG
GGT
77
Isidora=TCA
Glynda=CCT
Ursola=CAA
Dru=AAC
Ruthi=TGC
Konstanze=GGG
Odelia=CGT
Yolane=ATA
Rubia=TGT
Devan=AAC
Allyson=CCC
Iris=TCA
Deeyn=ATG
Gilligan=ACC
Marleen=GGC
Zulema=CCG
Kassandra=AAT
Merrielle=TGA
Lurline=CAT
Sonnie=GAT
Amanda=TGT
Winonah=GTG
Abra=TGG
Tamara=TAC
Aleda=CTC
Veradis=AGT
Alyce=CGC
Bill=CCG
Lenora=CAA
Cordelie=TTT
Dianna=TTT
Merline=CGC
Candra=GTA
Germain=CGA
Almeta=CTT
Inge=GTG
Stephie=ACG
May=TTA
Regina=GAA
Esme=ATA
Pavia=GCA
Rose=CAT
Demetris=CCG
Brittany=TGA
Hanna=CAT
Karylin=CGG
Quinta=GGA
Belicia=AGC
Annora=CAA
Jamie=TGC
Leilah=TGA
Starla=TGC
Melodee=GCC
Tallulah=CTT
Lesly=TGT
Iona=AAA
Theadora=ATC
Roana=CAA
Murial=ACC
Tammy=TGG
Melisa=GTA
Tilda=GCG
Jacquette=TCG
Ivonne=GGA
Neille=TTC
Sissie=CTC
Yettie=TGA
Cathe=CGG
Margeaux=TAT
Genni=GAG
Karalynn=AAA
Prudy=ATC
Hailee=ATT
Ardyth=GCG
Norma=AAG
Ashley=TCC
Desiree=CAA
TAACTAGGACTGATTGATGATAAT
29
Callida=TTTCCTACCCGCACCTGTAACGGG
Teodora=CCATAACGTTGTGTTCCACATGAC
Shay=GGCACGTAAGACTAAGCAAGTCGG
Philis=GGGACGAACAGGTAACTTAGTGGT
Pollyanna=CCGTGTCCATTTTTAACGAAGAAC
Selie=CTCCGCTACTTTCATTAGGATCGC
Cairistiona=CACTCGTTCCACGGCTGCGATGGC
Dottie=AACACTCATTGGCGGGGCATATCA
Delores=CAGGCTGATTTCTATCAGCAAACT
Martina=TCCTCTCACTTCTCTCAAGGAGGC
Brandy=TATGGGTTGCCGCGCTGCATCCCG
Alyssa=AGGTAGTCACCTGCCTGCGCACTA
Bevvy=TGAATTGATGCACCTCATACATTT
Lanni=CCTTGCATCCGATAGTGTCATTGG
Rhonda=ACATCCTCATGAGAATTGTGGTAG
Lana=CAGACTGTGGTTCCATAGATGCTG
Austine=AACCATCAATGGGGCAGTTAGTAG
Pavla=AAAAGTGCTGTACAGAACCGAACA
Luz=GGGAGTCACATTACCAATACGCCC
Lillian=GTAACTTGCAATCACACGGGTACT
Chicky=TTCCTTATATGAAACTCTGGATAG
Elfrieda=TTGTATGTTTGTCCGACTATTGCT
Geralda=GCTAAGGGTTCGTTCGTGTGTGCA
Eve=CCGCGAGAGCGGACTGACGGTATT
Tarra=CCAAGACGATAAGAGCCTTTAAGC
Shir=GAGATATTACGTGCTCTTTCTTGC
Dianna=AGTTGAACCGGTAATGACCAACGG
Twyla=TGACAATTTCCGGTAACAGAGGTA
Roseann=TCACGCTTAACGCTGAATATAACC
ACTTGTTTATTTGGCGC
69
Dyan=GCTTGTAGCCCGGGAAG
Kissee=CTGAGCCCGGTAGCGCC
Jacklin=AGCTTATTTATTCACAG
Minna=TTTACGTTACAATGGGC
Kally=GAACCGGGTAACGATAC
Bettine=GGACGCGCTTTTGGAGT
Joly=CACGCACTCATTTTCAG
Gilberta=AGGGGCCGGCGAAAAAT
Calypso=GCGGTTGTGTGAACAGC
Carlotta=TCGGGATCCCAACGCCG
Lelia=ATTTACAATCCCACCAT
Mechelle=AAGTCCTAGGTGGTCCC
Thea=TCCTTTTCTACCGTGCA
Daffy=TCAGGGCACGGTCGAGC
Martynne=TATTCCAATCGACTTAC
Trixy=CGCACAAGTGCGTTAAG
Marne=CGAGATAAATGTGGGAG
Bobbee=CAACTTCGACAGTTTAC
Modesta=CATGGCGAAGGTATTTC
Vita=TCTTGCATAGGATTAGC
Roxi=AGATTGCACCTGACCAG
Portia=ACATGGGTACACTTGTT
Silvana=GGATCGACGCAGAAGCT
Pearl=CGAGCACCGGGCCGGCT
Doralin=TAAGGCCGCCGCCACTG
Edwina=GATCACAGACCCGTCGC
Zaneta=CTTTTCAGCGGCAATGA
Hildagarde=TATGAGGATCAGTAATA
Milissent=CCAAGGGATAGGCCATC
Ardelle=CGCGAATGCCTGGGGCG
Cathrin=TCAGAAGCGATGAGCCC
Florinda=AGTGTAATTATGCCATT
Madalyn=AAATGGCGAGACTCACA
Clara=CACCTTCTGATGAACCA
Sheilah=CGTCTTTTTGACCGAGC
Hyacinthia=GTAGATATCCAAGATAG
Micaela=GCATCTCCTGAGTTCAA
Stephana=GACCAGAAGCTGGTCTC
Odille=TACACCACGACTCTGGT
Michel=AATACACCAACTGGGCC
Dorita=GGCTTCAGATACTGTAT
Mureil=GCGCCTGCTCGTTTATA
Shantee=GTCGGTAACTGCTCGTG
Zita=GGGCCTGATCAGATCGC
Stephi=CCTCGTTGGACGGGGGG
Nanci=GCAAGCTCTATTCTCAC
Illa=GGCTCCTGTATCCCACT
Galina=ATTTGGCTATCTTGCTA
Julianne=CCCAATGAAACAGAAGA
Ella=TAGTCCATACCGCGGAG
Kirsten=CCATCGCTTGTGTATAA
Kellsie=TGAGATGAGAACAACCA
Sherye=TCTCAGAATCGCCGGGA
Renee=AGATATTACGTCGCGTT
Hedvige=GCTACACCACAAATGTG
Del=TCGAGTTATATGAGGCT
Noel=CAGTCCAAGTGAGACCA
Daniela=AGCAAGACATAGAACCT
Felicle=TATGATCCCACGCCTCG
Blair=GGGCTACTGGGAACCCA
Lexine=ATAGATTTACTCCGTAA
Rhona=TCGTTATTCCGGATATA
Rosamond=AGTGGTAACGTATATCA
Valera=TATCGCTTAGCTAGGGA
Bobby=GATGCAACCTATGTGAC
Genna=GCTCCTGTAACTCGACA
Pet=ATCGGTCATGAGGCTCC
Idalia=ATAACCCCGTCTAATGT
Fay=AGAGTCACCCTCTCGAC
TCCTGGGCTTGGGG
23
Devinne=CTGTAACGATGGGG
Adrienne=GATAGTGATATTTC
Doralyn=GGACCACAAGGTCA
Sarette=GAATCGCTGTGGAG
Sosanna=GACTGTCCAGTGAT
Retha=TTATGTTCTCAACA
Ray=TATTTTAAACAAAA
Gertrude=GAATTAGCAATTCG
Aurelia=GAGAGTTCATTGGT
Becki=GCGCAGCTTACACA
Denyse=CATTCTCCTCAACC
Meredith=AAAAAGGGCCTCGA
Joleen=GATCATCCGTGAAC
Marje=ACTTTTATTCGGAA
Fredra=GTTCTCTACACGCC
Theresita=GCTTTTACGAATTA
Dyanne=GAGGGCCGGTGGGC
Kirby=AGATTCGCTCACTG
Melisenda=GCTTGACTCGTAAA
Fleurette=GGTGCATACACTGG
Valencia=CCGGAGCAACCTTG
Caresa=ACTTGCATTCTAGA
Terra=TGGTCACTAGCGAA
TTTTAACCT
83
Sena=GAAGACTTA
Maurine=TGCACCGCG
Arlette=GACGCGCGA
Shani=CCCTCGATT
Ruthanne=TCCTTGAGA
Ardisj=TCGCGAATA
Carley=TCGATCCCG
Doria=TAACCACAA
Danyette=CGCCCATAA
Lucille=GTTTCTGTA
Bernette=TAAGTTTCA
Bernelle=TATGGCCTG
Jacquie=GTCATAGTT
Jackie=TGTCGCAAC
Sibylla=GTTCTCCGT
Birgit=AGCAGACCC
Maighdiln=AGTCTGAAT
Florencia=ACGAACTCT
Astrid=ATTGGAAGC
Idalina=ACGCCATCC
Barbara-Anne=AACCTTCTA
Daryl=TTTCGGATA
Clemence=CCCCCCCGC
Alix=GTAAAGGAT
Lenette=GGTTCAGGA
Daryn=CGCCCGGAA
Victoria=TATTTACAA
Mirabelle=CGAATAAAT
Vally=AATGATTTT
Benny=AGTTTCCCT
Terza=CCATTAGAC
Emilie=ACCCAGGGG
Tiff=GCTTTAAGC
Dyanna=TAGCTCCTG
Roanne=TCTTAGTTA
Kenna=CGCCGCACC
Malia=GTGGTAAAA
Merrili=CGCTACGTT
Halimeda=CTGGAGCGT
Valma=TCGCTATTC
Florinda=GCTTGGCTG
Ainslie=CCGGGGACA
Leela=AGAACTGGT
Mareah=CCCTTTGCT
Brianna=CTGCAGTAG
Josephina=ATTTAAAAA
Jaime=ACCCCGACA
Lucila=ACCTTATAC
Sharon=AGACAGTCC
Lynette=TGACGCTAG
Jenilee=ATAAAACTT
Garnet=GGATACACA
Violante=TACTTCCAT
Roby=GTCTGGGGG
Olimpia=ATAATACTA
Noella=CGGTCCTGC
Charo=GCGTCTTAC
Nanci=AAATGGTAA
Cissiee=GCCCACTGT
Janot=AAAATACTT
Elissa=TTTAAGGTT
Jeane=TAGTAGAAG
Ronnica=GGAGGTCCT
Willie=TCCGCTTCC
Dulcy=TATTCATCG
Rikki=CCTTTTTGG
Layne=TTTGCAGGT
Cariotta=CAAGGGTCC
Shayna=ACGCTCTAA
Reiko=ACCTATACA
Erena=GTTCTCGCT
Davita=GATTCTGGT
Katine=CAGAGTGAT
Maible=GATGTCCAA
Wynn=ACGACACTA
Gisela=TGGGCAAAC
Kristina=CGATCTTGA
Alana=GATCAATGT
Tabitha=CCCAGGTCG
Junia=GAGAACTCA
Franni=TCTTCAAAC
Evvy=TTGCGAAAT
Marianna=GCGTCTCCA
GGAGGCCCTACCCGCGGGTGGCG
84
Deloria=AAGATCGTACAGGGGAGAACTTG
Truda=GTGTATTGAGGCGTCACGTCTCG
Celestine=TCCCCAGCTGGCAGTCTTTACCT
Joli=CTATCCAGTTCAAAACGGCCGAG
Herta=CCCTTACCTTACGCTATCGTGGA
Frankie=GAAACGTTAGAATGATGTAGTTA
Lucine=GCTCGCCGACCCTAGCGGGATCT
Novelia=CAGCTATACCGGAAGCACCACAA
Nannie=TCGTTATGGGGGCGAGGCTAATA
Katuscha=GTCAAGAATCGTATGCACTCAAG
Edeline=ACGGTACAAGTTAAGTAAAATAA
Devan=GGTTTCCGCTCCAGGCCTCGCCA
Roseline=CACCGCAGGATGTCAGTTTTTGG
Danita=GCAAATTATGTAGTCCTACAGTT
Pamela=GTAAGGCACCTGTCGATTGTAAA
Janie=CCATGCCTTTACAATACCTGGTA
Lusa=GCTTGCTAGCAGGTCGAGGCTCC
Eudora=AGTTGTCGAGTGGAAATCCTACA
Dawn=CGAAGTTAGAGATGACTCCCATG
Kylila=AGGTCTGTATTATTATGAACCAG
Chelsea=TGGCAGCCGGCAGGCGAGATCCC
Florencia=TGGAAACTTTCTCTAGCGCTTGT
Kym=ATACATATAACATACGGCAGAGG
Merrill=GTCTAGTGGTCATCTTCAACTCA
Birdie=CCTTGAAGAACCATTAGTCCCCA
Micki=ACTGCGCGAAGTGGCTTTGCTAA
Wendy=GTGGCGAGGAGGTACAAGCCGGA
Brandie=TCAAAACCAGAGCCGAGTAATGA
Elisa=CGTTTGATCTTGAGTAACGTAAT
Mei=AGCGCTAATTGTAAAATAGCCGC
Fredi=CATCGAATGGGGGCCGGCACGTC
Gerrie=CGCTAGCTACCACAAAATGGCCA
Allix=AGCGCAGGAGGACGCCTGTCCAA
Pennie=AGCTTGTATCGCCCTGAACGAAG
Ingeberg=GGGCGCCGCACCGATGGGGGACT
Adele=GAAGGTAGTGCGACTAAAAATTG
Winifred=ATTCCTTAGAAGCCAAGTAAAAA
Mehetabel=CTCGAGCATGGTATGTTCAGCAG
Saraann=GTCCCTCGGCTCTGGTGGGTAGG
Lindsay=GAGCTCCACTCTCTATCCACTAT
Amargo=GAATGAATATGGCCGCTTAGCAA
Emelda=GGGAAAGTGTCTTAAGGCAGTAA
Sybilla=GCTTAATTGACAGAAAGCTGAAT
Raphaela=CAGGTCGCGCGATAAGGACACAC
Melamie=TTGGAAAGGCTAATCTACAGCTA
Margareta=TGGCACCTATAAGGGCGTGTGGC
Ag=TACAATCCCGATGCCTTGCGCAA
Lanita=TTCCCTCAGACTAAGGGATTGGT
Oralie=CGACTCTTCCGATGGAGTAAGGT
Alexandra=GGTCTAGCGCTCCTTTCCTCCAC
Cristina=ACTGGAACCCGGTGCAGACGCAG
Alissa=TCTCTTTTAATTGCGCCGAAACA
Gusta=GAGCATCCTATAGTTATAGCTGG
Xylia=CAAACATTTATAATTCATGTTGT
Rhea=GATTCACGTTCGCAGCAGTTGAC
Christye=CAGGTGTCGCGCCGCTGCGTCTG
Brittni=CACATGGAGACGGGTGGCAGCAC
Nerte=CAGCTGGCTCATGGCCGCTAAAC
Arleen=CGAAACCTTGGGTTGGCGATGTT
Cary=CTCCCCATGGAGACCATCAAGCC
Cynthy=CATCGCGTAATTATAGAGACACG
Dierdre=GACATTCGGGGCGCCCTGCAGTT
Charlot=CGCTTAGTGGCCTGACTCGCCGT
Lorie=TGACACTGCCTCTACATAGGCTG
Maude=GTCACGGAAGACCTTATCCGCAT
Dorey=GTCTCGACAAACTAGACGGCCCA
Nina=GCATAAGTTTCTCGCGACTCAGA
Letti=GAGTAATTTGATCCAATGACTAT
Johnath=TTAAAGTGGTCCGATTCGATATT
Daloris=GTAGGAGCAGACCGATCGGCTAG
Becca=TCAATTGTATATCACAACGAGGT
Verena=ATGTATGAGGGAATTCACTTAGT
Billi=AGACTTGATCATATGTATCGCTA
Belle=CCCTTACAATAAAATACCACGGG
Katinka=ACCTGAAGCGCGGAATTGGGCAC
Rae=CTTGTATCGAGTGCTCGTTTTGA
Trenna=GTTCGGCCGGTCAGAGATAGGAC
Mair=TTTTATACCTTTCAAGCAGAGAG
Madonna=ATACCTAGCAAACGATGGGCATG
Matilde=AATCAAAGAGCTCTTTCGAACAG
Marnie=TGCAGCGAGTGATAGTTCGCGCT
Ariana=ATCCACCACGGCTTACAGTACCT
Aprilette=AACTGAAAGGATCTTCGCATGTC
Merridie=TGTACATAACTTGTTTCTCTCTT
GTCAGACGCTCTCAGAGT
92
Jaquelin=CGTGCCTCGTGATATCTC
Shena=TTGTGCTACACCAACAAG
Cassy=CAAGGACTTCGGGGGTGC
Eden=GTCATGAGTGCGGCAAGT
Ernesta=CATGCTGAACGACATAAC
Florance=GAGGATTCCGGACCCTCC
Ivie=AAGTTCGTGGCACTAATG
Melicent=GGGGCTGATGTGTGCAAT
Denna=AGCTAAGGCCTGGACTTA
Andi=GGAATTACACAGTGTTAA
Joya=GTGGCTTTACGAGCTAAC
Kari=GTATATCCAGTCTACGGA
Lynnet=TGCGGACCCCCCCCTAGA
Dusty=TTAACAGTGAACCATAGT
Charlene=AACAGAGTTTTGACAGGC
Mada=GCAAATCGCATCACACTA
Barrie=CATGGGACCCACTCGAAG
Maribelle=TCTCGCAGTGGTTTGGTA
Brenna=ACCTTGCCGATCCCGATG
Dinny=ACGTTCCAGACCCTTGGA
Vinni=ATTCAACTGAGCCACGGT
Shanna=AGTACGGCATATCTATCG
Zulema=GTCAAATATTGGCGACAA
Elle=ATCATCTCTACCGGGTTT
Annmaria=ACGTGCTTCAGACAAATG
Kaela=TTAACCAACTTTACCTGT
Ermina=TATCGACGTCGCTGAGAT
Ardine=GTGAGCTTCCTATTGATA
Shoshanna=CGATTTCATGGAGCCTTC
Pavla=GCTTGGCACCGAGCTGGT
Marieann=GGAAGATCACCTTCAAAC
Estele=GAGTCCTATACAATGCGT
Bridget=TCGATTCTCAACGACAGA
Carolann=TCGTATCTATCGTAGATT
Charyl=GTCTACTACCCCGTTATT
Lorette=ACATCTGCACCAGCCAAA
Estell=TGTCGCGCACCTTCAATT
Lorelle=CTTGGGTGGACAGAACTC
Hildagarde=TATGCTCTGGTTTTCGTC
Wally=GCCGAAATCGATAGGTCC
Alie=CCGCTTGCGGTTGTGCGG
Willy=TTCTTGAGAGTTTTAGTT
Jodie=GCCCATGTGGTTTTCACG
Courtnay=ACCCTTCTAATTAGTACA
Buffy=CTTTTTTAGTAAAGCACG
Kat=TGTTCTGGGCGTGAAAGT
Aimee=GTCCGAAATGACCTCGTG
Myrtle=CCTTCCATGTACGCGAAA
Elianora=ACTAGGAAGGAATTGGGC
Blondelle=ACGAGGAGCTTCTGGGGT
Abby=ACGGTGGTCAGACCGACA
Roshelle=AAATCGGCCCTCGCATAA
Kelsy=TTGAACTGATCTTAACTG
Rose=ACTAACACAAAGAGCCGA
Thomasin=GGGACTTAAATCTGGTGC
Alexandra=CTGGAAAGTTGTTCTTGA
Rowe=GTCCAATCCCACTTATGT
Ethyl=CAATACGGGGTATCGGGT
Valida=CATACGCCCATAATGGGA
Elane=CGGCTCAACCGGCCTGTC
Dorree=ATGTTAATCCGCCCGGTA
Malory=TTTTCCATCCTGCTGAGG
Kathryn=CTCAGAAATAATTACGAT
Prisca=CGGGCAGATCTCTCCTGT
Lyssa=CTCTGTAGTTATCATTAG
Lydie=TCGAACCCGAAAGGACCC
Willa=ACTAGTCTCTAGAGAATA
Jenifer=CGTCCGCACCGTGAATCT
Tuesday=GTAGGACACACTTTACTA
Dalila=ATTAGACACGAACGCACA
Maggie=CGGCAACTGCTCGATGGT
Ajay=GCGCTAGTGGCCTATTCG
Marsha=GCTAGCAGATTGTTATCT
Ethel=CAGCTCACTTACAGAACC
Doris=GAAGGTCAGTCACTTCCT
Krissy=TGAGCCAATGCCTGCCGT
Cele=GGTGGCGAGGTTTGTCCC
Brandy=TACTGCGCGTAGTGTAAT
Marcelle=GCGACTTTTCACATTCGA
Kitty=GTGACAGTAGTGAGACAC
Nicolette=GGCTCAAGTTATTAGTTT
Gertrudis=ATAGGGGCCGGGGCCGAC
Karleen=GCGAGTGGTGGGGCACAT
Reeta=CCCCCAAAGTGGGGGAGA
Letti=TTATTACCATAAATTACT
Lacy=GGTCACCTTATGGCACAC
Gwynne=ATGTCGCAGCTCAAATGT
Audy=CCCGCTCAGCTGTCGTCG
Desiree=TTGACGGATAGTAACCAC
Marie-Jeanne=TACCCTTAGATCCGAGTC
Jillayne=TGGTGGACATTATTTACA
Zilvia=TCCTCTCAACCGCCGGTT
